           F 40,54,24

NO textures/north.xpm
                SO textures/south.xpm
C 244,162,97
WE textures/west.xpm

EA textures/east.xpm


111111111111111111111
1000000000000000000011
11000000000000000000011
1100000000000000000001
11000000000111000000011
1000000000000000000011
1000011000000S0000001
1000000000000000000011
11000000000000000000011
 11000000000111100000011
  11000000001 11000000011
   1000000011 1000000001
  1100000000111100000001
  1000000000011100000011
  110000000000000000000111
   111000000000000000000011
    11000001000001000000011
    1000000000000100000001
    11000000000000000000011
     1100000001000000000001
      1111111111111111111111
