F 40,54,24

NO                                                                                         textures/bricks.xpm
SO textures/sand.xpm
WE textures/ice.xpm
C 244,162,97
EA textures/woolsnow.xpm

111111111111111111111111
100000000000000000000001
100000000000000000000001
100000000N00000000000001
100000000000000000000001
100000000000000000000001
100000000000000000000001
100000111110000101010001
100000100010000000000001
100000100010000100010001
100000100010000000000001
100000111100001010100001
111111111111111111111111