
F 40,54,24
C 244,162,97

NO textures/bricks.xpm
SO textures/sand.xpm
WE textures/ice.xpm
EA textures/woolsnow.xpm

1111111111111111111111111
100000N11110000001       
1111111111111111111111111