F 255,255,255
C 0,10,10

NO textures/north.xpm
SO textures/south.xpm
WE textures/west.xpm
EA textures/east.xpm


11111111111111111111
100000000J00000000111
1111111111111111111111