F 255,255,255
C 0,10,10

NO textures/north.xpm
SO textures/south.xpm
WE textures/west.xpm
EA textures/east.xpm


1111111
1000001
1111111111111111111111111111
10S01111111
11001110 11
11100111
11110000111111
