F 255,255,255
C 0,10,10

NO textures/north.xpm
SO textures/south.xpm
WE textures/west.xpm
EA textures/east.xpm


11111
10S00
10001
10001
11111