F 255,255,255
C 0,10,10

NO textures/north.xpm
SO textures/south.xpm
WE textures/west.xpm
EA textures/east.xpm



111111
1         0
111111
10S011
100011
111111